// Traducción al español de software WolfWatch por Loan.J (NaolShow)
// Este archivo de idioma se elimina y vuelve a crear en cada lanzamiento

// ---------- Configuraciones ----------
settings: Configuraciones

generalsettings: Configuraciones generales
videoplayersettings: Configuración de reproductor de video y listas de reproducción
advancedsettings: Ajustes avanzados
informations: Informaciones

// Configuraciones generales
language: Idioma
autoupdates: Verifique en cada lanzamiento si hay una actualización disponible
manualupdatecheck: Verificación de actualización manual

//  Configuración de reproductor de video y listas de reproducción
stretchtofit: Estira el video para que se ajuste a la pantalla
sortvideoslist: Ordene la lista de videos y listas de reproducción
ascending: Ascendente
descending: Descendente

maxdropdownplaylists: Número máximo de listas de reproducción visualizadas al mismo tiempo en la lista

// Ajustes avanzados
showfiles: Mostrar archivos
resetfiles: Restablecer archivos

// Informaciones
numberplaylists: Número de listas de reproducción
weightplaylists: Peso de listas de reproducción
refreshinformations: Actualizar información

// ---------- Buzon de mensaje ----------
newversion: Una nueva versión está disponible, haga clic en YES para descargarla.
nonewversion: ¡No hay una nueva versión disponible!
errorconnection: Se ha producido un error de conexión para determinar si una nueva versión del software está disponible, se excede el tiempo de espera, vuelva a intentarlo más tarde.

deletefiles: ¿Quieres restablecer el software?
restartsoftware: Por favor, reinicie el software

playlistexist: Esta lista de reproducción ya existe
videoexist: Este video ya existe
selectvideo: Seleccione un video
selectplaylist: Seleccione una lista de reproducción
deletevideo: ¿Quieres eliminar este video?
deleteplaylist: ¿Quieres eliminar esta lista de reproducción?

// ---------- Las listas de reproducción ----------

// Textos
playlists: Las listas de reproducción
playlistslist: Lista de listas de reproducción

playlistname: Nombre de la lista de reproducción
videoname: Nombre del video
videodescription: Descripción del video
cancel: Cancelar

open: Abrir

filename: Nombre del archivo
filedescription: Descripción del archivo
fileduration: Duración del archivo

// Tira de menú contextual
playvideo: Mira el video
addvideo: Agrega un video
removevideo: Eliminar video
editvideo: Editar video
exportvideo: Exportar video

addplaylist: Agregar una lista de reproducción
removeplaylist: Eliminar lista de reproducción
editplaylist: Editar lista de reproducción
exportplaylist: Exportar lista de reproducción
